tk=Arkitektur- og designhøgskolen i Oslo
tu=Bane NOR – Jernbanebiblioteket
la=Unit
yv=Chr. Michelsens Institutt
ig=CICERO Senter for klimaforskning
vm=Det teologiske Menighetsfakultet
uj=Dronning Mauds Minne Høgskole for barnehagelærerutdanning
ih=Fiskeridirektoratet 
td=Folkehelseinstituttet
xg=Forsvarets høgskole
jc=Fridtjof Nansens Institutt
tb=Handelshøyskolen BI
vf=Havforskningsinstituttet
up=Høgskolen i Innlandet
um=Høgskolen i Molde
ub=Universitetet i Sørøst-Norge
uc=Høgskolen i Østfold
xm=Høyskolen Kristiania
uv=Høgskulen i Volda
xa=Høgskulen på Vestlandet
yq=Institutt for energiteknikk
ij=Institutt for samfunnsforskning
if=Krigsskolen
vq=Kriminalomsorgens høgskole og utdanningssenter KRUS
xw=Kunsthøgskolen i Oslo
tf=Lovisenberg diakonale høgskole
jh=Museum Stavanger
wn=NILU - Norsk institutt for luftforskning
uz=NLA Høgskolen
vh=Nofima
ud=Nord universitet
yu=Nordisk institutt for studier av innovasjon, forskning og utdanning
vp=Norges Bank
jf=Norges geologiske undersøkelse
it=Norges Geotekniske Institutt
h=Norges handelshøyskole
ta=Norges idrettshøgskole
ia=Norges musikkhøgskole
tc=Norges miljø- og biovitenskapelige universitet
a=Norges teknisk-naturvitenskapelige universitet
jg=Norges vassdrags- og energidirektorat
je=Nordlandsforskning
wd=Norsk Folkemuseum
vx=Norsk institutt for bioøkonomi
vg=Norsk institutt for naturforskning
ip=Norsk institutt for kulturminneforskning
tg=Norsk institutt for vannforskning
yy=Norsk Polarinstitutt
ik=Norsk Utenrikspolitisk Institutt
jd=Norut Northern Research Institute 
ir=NTNU Samfunnsforskning
xq=Politihøgskolen
tj=RBUP Øst og Sør
wa=Riksantikvaren
is=RURALIS - Institutt for rural- og regionalforskning
xu=Sámi allaskuvla
iv=Senter for omsorgsforskning
wj=SINTEF
iu=Sjøkrigsskolen
im=Statens arbeidsmiljøinstitutt
ty=Statens vegvesen
vl=Statistisk sentralbyrå
iw=Sykehuset Innlandet HF
jb=Transportøkonomisk institutt
uk=Universitetet i Agder
ur=Universitetet i Stavanger
vd=VID vitenskapelige høgskole
